2,1,2,1,2,1,2
3,2,3,2,3,2,3
3,3,0,4,0,3,3
3,4,4,4,4,4,3
2,1,1,1,1,1,2
