0,1,2,1,2,1,0
2,3,3,3,3,3,2
3,4,4,0,4,4,3
3,4,4,4,4,4,3
2,3,3,3,3,3,2
